0 0 0 0 0 0 0 0 0 0 0 0 0 0 0 0
0 0 0 0 0 0 0 0 0 0 0 0 0 0 0 0
0 0 0 0 0 0 0 0 0 0 0 0 0 0 0 0
0 0 0 0 0 0 0 0 0 0 0 0 0 0 0 0
0 0 0 0 0 0 0 0 0 0 0 0 0 0 0 0
0 0 0 0 0 0 0 0 0 0 0 0 0 0 0 0
0 0 9 9 9 9 9 9 9 9 9 9 9 9 9 9
0 0 4 3 3 3 3 3 3 3 3 3 3 3 3 3
1 1 1 5 7 7 7 7 7 7 7 7 7 7 7 7
2 2 2 2 6 8 8 8 8 8 8 8 8 8 8 8
2 2 2 2 2 6 8 8 8 8 8 8 8 8 8 8 
2 2 2 2 2 2 2 2 2 2 2 2 2 2 2 2